8 5 S
....................
....................
..██████████████████
..█B________________
..█_________________
..█_______X______X__
..█_________________
..█_________________
..█_________________
..█_______X______X__