8 5 S
....................
....................
..█████..██████████.
..█B__█..█X______X█.
..█___████________██
..█_________________
..█_________________
..█_________________
..█_________________
..█_________________
..█_________________