..........
..........
..██████..
..█B___█..
..█____█..
..█____█..
..█____███
..██______
...█______
...█______