...........
...........
...██████..
...█B___█..
...█____█..
...█____█..
...█____███
...██______
....█_██D██
....█_█___█