..........
..........
..████████
..█B______
..█_______
..█_______
..█_______
..█_______
..█_______
..█_______