8 8 S
.........
.████████
.█B______
.█_______
.█_______
.█_______
.█_______
.█_______
.█______H