8 8 S
.........
.████████
.█B___█__
.█____█__
.████D█__
.█_______
.█_______
.█_______
.█______H