8 8 S
.........
.████████
.█B___█__
.█____█__
.████D█__
.█_______
.█_██D███
.█_█_____
.█_█_██_H