15 9 S
........█████...
........█___█...
.█████..█___█...
.█B__█..█___█...
.█___█████D█████
.█___________D_█
.█__██D██_████__
.█__█___█_D__█__
.██_█___█_█__█_█
..█_D___D_████_█