15 9 S
........█████...
........█P__█...
.████████___████
.█B_____________
.█______________
.█______________
.█______________
.█______________
.██_____________
..█_____________