8 7 S
50 0
..........
.█████████
.█B___█___
.█____█___
.████D██__
.█________
.█_█████__
.█_D___█__
.█_█___D__