8 7 S
50 0
..........
.█████████
.█B_______
.█________
.█________
.█________
.█________
.█________
.█________