8 8 S
50 0
..........
.█████████
.█B___█___
.█____█___
.███D███__
.█________
.█_█████__
.█_█___█__
.█_D___█__
.█_█___D__