8 8 S
50 0
..........
.█████████
.█B___█___
.█____█___
.████D█___
.█________
.█________
.█________
.█____████
.█____████