15 9 S
....................
....................
..████...████..████.
..█B_█...█_X█..█X_█.
..█__█████D██████D██
..██D█______________
...█___█D███D█_██D██
...█_███__█X_█_█X__█
...█___███████_█████
...███______________