9 8 S
..........
.█████████
.█B_______
.█________
.█________
.█________
.█________
.█________
.█_______H