9 8 S
..........
.█████████
.█B___█___
.█____█___
.████D█___
.█________
.█________
.█________
.█_______H