15 9 S
....................
....................
..████...████..████.
..█B_█...█__█..█__█.
..█__█████D██████D██
..██D█______________
...█___█D███D█_██D██
...█_███__█__█_█___█
...█___███████_█████
...███______________