15 9 S
........█████...
........█P__█...
.█████..█___█...
.█B__█..█___█...
.█___█████D█████
.█___________D_█
.█__██D██_████__
.█__█___█_D__█__
.██_█___█_█_P█_█
..█_D___D_████X█