15 9 S
........█████...
........█P__█...
.█████..█___█...
.█B__█..█___█...
.█___█████D█████
.█_____________█
.█______________
.█______________
.██__________█_█
..█__________█X█