........
........
.█████..
.█B__█..
.█___███
.█______
.█______
.█__██D█