8 7 S
50 0
..........
.█████████
.█BMS_____
.█________
.█________
.█________
.█________
.█________
.█________