6 5 S
B___█___
____█___
███D███D
________
_█████__
_D___D__